11111111
1E100001
11111001
101C1001
10000001
10000P01
11111111
