11111111
1E100001
10111001
101C1001
10111001
10000P01
11111111
