11111111111111111111111
1E01001000000001C000001
10110011000000011111101
10000000000C00000000001
11111100000000011111101
1000000111001001C000001
10111111110C10011111111
100000111111100000010P1
1111101C1000100010010C1
11111010101010001001001
1C000010001000001000001
11111111111111111111111
