11111111111111111111111
1P0001011111010000001E1
10001101111101100000101
10000000000000000000101
1000000000000000000C1C1
1C111111111111111111101
10000000000000000000101
1111111111111111111C101
10000000000000000000101
1C111111111111111111101
100000000000000000000C1
11111111111111111111111
