11111111111111111111111111111
1C0101010000000000010P1111111
10111111100000000001001111111
10101110100000001001001111111
10110001100000001001001111111
10111111100000001000001111111
100000000000000010000C1111111
10111001110111001111111111111
1C000001000001000000001111111
1111110100C001010101011111111
1E0000010000010000000C1111111
11111111111111111111111111111
11111111111111111111111111111
11111111111111111111111111111
11111111111111111111111111111
