11111111111111111111111
10010001000000000110001
10010001001100000110001
10011011001110000110001
10000000001111000000001
11111111111111111111111
