11111111111111111111111
1C0101010000000000010P1
10111111100000000001001
10101110100000001001001
10110001100000001001001
10111111100000001000001
100000000000000010000C1
10111001110111001111111
1C000001000001000000001
1111110100C001010101011
1E0000010000010000000C1
11111111111111111111111
