11111111111111111111111
110000011000000000010P1
11000001100000000001001
11000001100000001001001
11110111100000001001001
10000000000000001000001
10111000000000001000001
10111001101011001111111
10000001111111000000001
11111101011101010101011
1E000001100011000000001
11111111111111111111111
