11111111111111111111111
110000011000000000010P1
1100C001100000000001001
11000001100000001001001
11110111100000001001001
10000000000000001000001
101110000000000010000C1
10111001101011001111111
1C000001111111000000001
11111101011101010101011
1E0000011000110000000C1
11111111111111111111111
